###########################
#.#.#.#.#.#.#.#.#.#.#.#.#.#
#.#######.#####.#.#.#.#.#.#
#.#.#.#.#.#.#.#.#.#.#.#.#.#
###.#.#.###.#.#.#.###.#.#.#
#.#.#.#.#.#.#.#.#.#.#.#.#.#
#.###########.###.#.###.#.#
#.#.#.#.#.#.#.#.#.#.#.#.#.#
#.#.#.#.###.#.#.#####.###.#
#.#.#.#.#.#.#.#.#.#.#.#.#.#
#.###.#######.#.#.###.#.#.#
#.#.#.#.#.#.#.#.#.#.#.#.#.#
#.#.#.#.###.#.#.#.#.###.#.#
#.#.#.#.#.#.#.#.#.#.#.#.#.#
#.#.#.#.#.#.###.#.###.###.#
#.#.#.#.#.#.#.#.#.#.#.#.#.#
#.#######.#######.#.###.#.#
#.#.#.#.#.#.#.#.#.#.#.#.#.#
#.#.#.#.#####.#.###.###.#.#
#.#.#.#.#.#.#.#.#.#.#.#.#.#
###.#.###.#.#########.#.#.#
#.#.#.#.#.#.#.#.#.#.#.#.#.#
#.###.#.#####.#.#####.#.#.#
#.#.#.#.#.#.#.#.#.#.#.#.#.#
#.#.#############.#.###.#.#
#.#.#.#.#.#.#.#.#.#.#.#.#.#
###########################
