#####################################
#.#...#...#...#...............#.....#
#.#.#.#.#.#.#.#.###.###.#####.#.###.#
#...#...#...#.#...#...#.#...#.#...#.#
#.###########.###.###.#.#.#.#.###.#.#
#...#.......#.#.....#.....#.#.....#.#
###.#.#####.#.#.###.#.#####.#######.#
#...#.....#.....#...#.#...#...#...#.#
#.#.#####.#######.#.#.#.#.###.#.#.#.#
#.#.#...#.........#.....#...#...#...#
#.#.#.#.###########################.#
#.#.#.#...##################......#.#
#.#.#.###########################.#.#
#.#.......###...#.........##....#...#
#.###.###.#####.#.#.###.#.#####.###.#
#.....#...###...#.#...#.#.##..#.#...#
#.#####.#.###.###.###.#.#.###.#.#.###
#.#...#.#.###...#...#.#.#.###...#...#
#.#.#.#.#.#####.#.#.#.#.#.#####.###.#
#...#...#.###...#.....#...##..#.....#
#.#.#########.#######.#.#####.#####.#
#.#.......###.#.....#.#...###...#...#
#.#######.###.#.#.#.#.###.#####.#.#.#
#.#.....#.###.#.#.#...#...##..#...#.#
#.#.###.#.###.#.#.###.#.#.###.#####.#
#...#...#.###...#.......#.##........#
#.###.###.#######################.###
#...#.....##################....#...#
###.#.#####.###.#.#.#####.#####.#.#.#
#...#.#.....#...#.#.....#...#...#.#.#
#.###.#.#####.###.#.###.###.#.###.#.#
#.#...#.....#...#.#...#.#...#.#...#.#
#.#.#.#####.#.#.#.#.#.#.#.###.#.#.#.#
#.....#.....#.#.#.#...#.#.#...#.#...#
#.#####.#####.#.#.#####.#.#.###.#.#.#
#.............#.........#.......#...#
#####################################
