#########################
#.##.#.#.##.##.#.####.##.
#.#.....#..#.#..#..#.#...
#...#.#.#..#..#.#.##.#.#.
#..#.##..#.#...##.##...#.
#..##..#..#.....###...##.
#..##.##.##...#####...##.
#.#..####.#..##.##.#..#..
#...###.##.##.#..##..#.#.
#..###.##.###.##.#.###...
#.###.##.#.##..#..#.##...
#.#..###....#.#....##.#..
#.#...#.#....#.....#.#.#.
#..#...#....#.#...#...##.
#.#........#.#.#.#..##.#.
#.#....#..###.##.#.#.##..
#.#.#..#....####.##..#.#.
#..##..#...##.###..###...
#..#.#....##..###..###...
#...##.....#.#.####.###..
#.#.#.#.###.##.###.#.###.
#..###.########.###.#.#..
#...#.#.#####.#.##.#.###.
#.##.#.####.##.##.######.
#########################
