#####################################
#.#.............................#...#
#.#.###########.#.#####.#.#####.#.#.#
#.#.....#.....#.#.....#.#.#...#...#.#
#.###.#.#.#.#.#.#####.#.#.#.#.###.#.#
#.....#...#.#.#.....#.#.....#.......#
###########.#.#####.#.#######.#######
#...........#.....#.#.......#.......#
#.###.#####.#.###.#.#.#.###.#######.#
#.........#.#...#.#.#.#...#.........#
#########....................##.###.#
#..........########.########....#...#
#.########.########.########..###.#.#
#.#........##...#.........##......#.#
#.#.######.##.#.#.#######.##..#####.#
#.#...#....##.#...#.....#.##........#
#.#.#.#.##.##.#####.###.#.##..#####.#
#...#...#..##.#.......#.#.##..#.....#
#.#######..##.#.#####.#.#.##..#.#.###
#.......#.....#.#...#.#.........#...#
#######.#..##.#.#.#.#.#.####..#####.#
#.......#..##.#...#...#...##..#...#.#
#.#.###.#..##.#.###.#####.##..#.#.#.#
#.#.#...#..##.#.#...#.....##..#.#...#
#.#.#.###..##.#.#.###.######..#.###.#
#.#.#.#....##...#.........##..#.#...#
#.#.#.#.##.########.########..#.#.###
#.#.#...#..########.########..#.#...#
#.#.#.###.....................#.###.#
#.#...#.....#...#.#.#...#.#...#.#...#
#.#####.###.#.#.#.#.#####.#.###.#.#.#
#.#.....#...#.#...#.....#.....#.#...#
#.#.#####.###.#.#####.#.#####.#.#.###
#.#.....#.#...#...#...#.#...#...#...#
#.#.###.#.#.#.###.#.#.#.#.#.#.###.#.#
#.......#...#.......#.....#.........#
#####################################
