###########################
#...#.....#...............#
###.#.#.#.#.#.#####.#####.#
#...#...#...#...........#.#
#.#.###.###############.#.#
#.#.....#.........#...#.#.#
#.###.###.#######.#.#.#.#.#
#.#...#...#.....#.#.#.#.#.#
#.#.###.#.#.###.#.#.#.#.#.#
#.#.#.....#.........#...#.#
#.#.#.#########.#########.#
#...#.#...#...#.......#...#
#####.#.#.#.#.#####.#.#.###
#.....#.#...#.......#.....#
#.#.#.#.#################.#
#.#.#.#.....#.............#
#.#.#.#####.#.#.###.#####.#
#.#.#...#...#.#...#.....#.#
#.#.###.#.###.###.#####.#.#
#.....#.#.......#.....#.#.#
#####.#.#######.#####.#.#.#
#.....#...#...#...#...#.#.#
#.#.#.###.#.#.###.#.###.#.#
#.#...#.....#...#.#.#.....#
#.#####.#######.#.#.#.###.#
#...................#.....#
###########################
