###########################
#...#...............#.....#
#.#.#.#####.#####.#.#.#.#.#
#.#.#.....#.#.....#...#...#
#.#.#####.#.#.###########.#
#.#.......#.#.#.......#...#
#.#.#######.#.#.#####.#.#.#
#...#.....#.#.#.#...#...#.#
#.###.#.#.#.#.#.#.#.###.#.#
#.....#.#.#.#.#...#.#...#.#
#.#####.#.#.#.#.###.#.#.#.#
#.......#.#.#.#...#.#...#.#
###.#.###.#.#.###.#.#####.#
#...#.#...#.#.....#.......#
#.#.#.#.###.#.###.#.#######
#.#...#.#...#.....#.#.....#
#.###.#.#.#.###.#.#.#.#.#.#
#...#.....#.....#.#.....#.#
###.#.###########.#######.#
#...#.#...........#...#...#
#.###.#.#######.###.#.#.###
#.....#.......#.....#.#...#
#.###########.#######.###.#
#...............#...#...#.#
#.#.#.#########.#.#.###.#.#
#...#.............#.......#
###########################
